0tolerance	0 tolerance
100favoritesongs	100 favorite songs
10ThingsILike	10 Thing sI Like
12dayclassic	12 day classic
16andPrego	16andPr ego
1DAYS	1 DAYS
1friend	1 friend
1thingicanstand	1 thing i can stand
20PrettiestFollowers	20 Prettiest Followers
21stEdu	21s tEd u
2Ocutestfollowers	2 Ocutestfollowers
2pack	2 pack
3097	3097
360idev	360 i dev
3hrive	3h rive
48Lawsofpower	48 Laws of power
501HJLDAY	501HJL DAY
5of5	5 of 5
5yrold	5 yr old
76451320846293	76451320846293
84	84
9LOUNGE	9 LOUNGE
A590	A 590
ACMS	AC MS
AG	AG
ALL-STARS	ALL - STARS
AOWWW	AOWWW
ASHAMED	ASHAMED
ASHLEIGHTAYLOR4MISSTSU	ASH LEIGHT AY LO R4MISSTSU
AUSTRALIAWANTSBIEBERBACK	AUSTRALIA WANTS BIEBER BACK
ActionIdea	Action Idea
Adorkable	Adork able
AfricanProverbs	African Proverbs
Airdrie	Aird rie
Aleague	A league
AlmedaSkatinRink	Al me daS katinRink
AlwaysandForever	Alway sand Forever
AndreReedHallOfFame	Andre Reed HallO fFame
AnimalAbuse	Animal Abuse
Aqain	A qain
ArgusCycleTour	Argus Cycle Tour
AsianPeopleSayings	Asian People Sayings
AskThatBitchForID	Ask That Bitch Fo rID
AustriaWantBieber	Austria Want Bieber
Az668i	A z668i
BADCOMBO	BAD COMBO
BATYOT	BATYOT
BBallWives	B Ball Wives
BENEDICTINECIRCLE	BENEDICT IN E CIRCLE
BIGBANGisBACK	BIG BANG is BACK
BISHPLEASE	BISHPLEASE
BLUETEAM	BLUE TEAM
BOSSNATION	BOSS NATION
BWELA	BWELA
BadPickUpLines	Bad PickUp Lines
BallPlayaSwag	Ball Playa Swag
Barbara	Barbara
BdayBash	BdayBash
BeOut	Be Out
BedRock	BedRock
Beirut	Beirut
BerryWhite	Berry White
BibleVerse	Bible Verse
BieberFact	Bieber Fact
BiggestAssKicker	Biggest Ass Kicker
BioshockInfinite	Bio shock Infinite
BizLife	BizLife
BlackandGold	Black and Gold
BleedingFrogs	Bleeding Frogs
BodybyVi	Body by Vi
Bohol	Bohol
Boostin	Boos tin
BrainStorm	BrainStorm
BraveForGaga	Brave For Gaga
BringBackCatchphrase	Bring Back Catch phrase
BrowardCountyQuotes	Broward County Quotes
BumtasticDAY	Bumt as tic DAY
ButYouTweetinThough	But You Tweet inT hough
CAMPBELLTON	CAMPBELL TON
CEIgala	CEI gala
CHERISH	CHERISH
CKBVideo	C KB Video
CNNWikiWars	C NNWikiWars
COMMUNITYPAYBACK	COMMUNITY PAYBACK
CTD	CTD
CUBS	CUBS
CallTherapist	Call Therapist
Cannes	C ann es
CarrieFisher	Carrie Fisher
CeleberityApprentice	Celeb e rityApprentice
CescStayAtArsenal	C esc Stay At Arsenal
CharlieSheenHBOShows	CharlieSheenH BO Shows
ChennaiRental	Chen nai Rental
ChildHoodMemoriess	ChildHood Memories s
ChrisBFAMEMarch22	Chris BFAMEMarch22
Cius	Ci us
Cleeve	C le eve
Cobain	Cobain
CockBlock	Cock Block
ComeWithMe	Come With Me
Confam	Conf am
CoonMusic	Coon Music
Corfu	C or fu
CrazyCatLady	Crazy Cat Lady
Crucible	Crucible
CulverCity	Culver City
DALLASMAVS	DALLAS MA VS
DConIdol	D Con Idol
DILLYDAY	DILLY DAY
DJMixes	DJ Mixes
DOCUMENTARY	DOCUMENTARY
DTBM2	DTBM2
DailyDealComATL	DailyDealComATL
DamnTeenQuote	Damn Teen Quote
DarkieTendencies	Darkie Tendencies
DeadBeat	DeadBeat
DearAlmighty	Dear Almighty
Delhi_Hotels_Booking	Delhi _ Hotels _ Booking
Derbyshire	Derby shire
DewTour	Dew Tour
Dipset	Dip set
DirtyDozens	Dirty Dozens
DoSomething	Do Something
DontIgnoreIt	DontIg no reIt
DoubleDhamaal	DoubleD hama al
DrEvil	Dr Evil
DreamsCameTrue	Dreams Came True
DueDate	Due Date
DwightSchrute	Dwight Sc hr u te
ELEMENTTONIGHT	ELEMENT TONIGHT
ESC2011	ESC 2011
Eargasms	Ear gas ms
Eastender	East ender
ElNino	El Nino
Emporio	Emporio
EndOfTheStory	End Of The Story
EpicJokes_	Epic Jokes _
Et	Et
Extenze	Extenz e
EyeCon	Ey eCon
FEB20thPROMENADE	FEB20thPROMENADE
FFSROCKS	FFSROCKS
FIXEDTWEET	FIXED TWEET
FOLLOW------	FOLLOW ------
FREESEXONTHEBEACH	FREES EXON THE BEACH
FTK	FTK
FaceDown	FaceDown
FactAboutTaylor	Fact About Taylor
Fanfic	Fanf ic
FavoriteGoGoQuotes	Favorite GoGo Quotes
FellasFollowNow	Fellas Follow Now
FewOfMyFollowers	Few Of My Followers
FilmXI	Film XI
FleurHupston	FleurHupston
FlirtyTweet	Flirty Tweet
FollowForAFollow	Follow ForA Follow
Foolish	Foolish
ForgotAboutDre	ForgotAboutD re
France	France
Freebands	Free bands
FridayFreebies	Friday Freebies
Frumchat	Frumchat
Fugitive	Fugitive
FuturisticDrop	Futuristic Drop
GAGA11MILLION	GAGA 11 MILLION
GFWS	GFWS
GLORYDEC7	GLORY DEC 7
GODISGOOD	GO DIS GOOD
GURL	GURL
Gala	Gala
Galloway	Galloway
GeekMoment	Geek Moment
GetInTune	Ge tIn Tune
GettingHitByATruck	Getting Hit By A Truck
GhettoWordsOfTheDay	Ghetto Words Of The Day
Give	Give
GoC	Go C
GobackSBS	GobackSBS
GodAwfulMovie	God Awful Movie
GoodDaughterTweet	Good Daughter Tweet
Goodburger	Good burger
GottoDance	G otto Dance
Grannys	Grannys
Greening	Greening
GrownWomanLovin	Grown Woman Lo vin
HAMA	HAMA
HBC	HBC
HEAVYHUSTLE	HEAVY HUSTLE
HOMESTAGE	HOME STAGE
HOURGLASS	HOURGLASS
HYP	HYP
Hackgate	Hack gate
HappyBDayChesterBe	Happy BDayChesterBe
HappyBirthdayBiebs	HappyBirthdayBiebs
Harrington	Harrington
HateItOrLoveIt	Hate ItO rLoveIt
HeadWelch	Head Welch
HeenimFighting	Hee nim Fighting
Hiccups	Hiccups
HighestHotel	Highest Hotel
HoesOutHereFucking	Hoes Out Here Fucking
Homie	Ho mie
HoodBumperStickers	Hood Bumper Stickers
HotAsHell	H otA sHell
HowTVRuinedYourLife	How TV Ruined Your Life
I18n	I18n
IAMCANADIAN	I AM CANADIAN
IDreamedADreamGlee	I Dreamed A Dream Glee
IHAVEBIEBERFEVER	I HAVE BIEBER FEVER
ILOVEYOUTRAN	ILOVEY OUTRAN
ILoveKpop	ILoveK pop
IMT111	IMT 111
INTERPOL	INTERPOL
ISeeRightThruYou	I See Right Thru You
IamAngus	I am Angus
IfIHadAGenie	IfIH adA Genie
IfTupacWasAlive	If Tupac Was Alive
Ilovethissong	I love this song
ImaBeliever	I ma Believer
ImfromAplaceWhere	I mf romA place Where
InMyPants	In My Pants
IndonesiaWantsSS	Indonesia Wants SS
InsuranceClaims	Insurance Claims
Ipa	I pa
ItsAJLSThing	ItsAJLS Thing
ItsFridayHoe	Its Friday Hoe
JAFRA2011	JAFRA2011
JESSIE	JESSIE
JPBFreebieFriday	JPBFreebieFriday
JUDGMENT	JUDGMENT
JamaicaPlain	Jamaica Plain
JamaicanPhrases	Jamaican Phrases
JayFact	Jay Fact
JesusDidIt	Jesus Did It
JoeMusic	Joe Music
Jorts	J orts
June3	June 3
JustAddWater	Just Add Water
K-1	K-1
KILLINIT	KILL IN IT
KKeBook	KKeBook
KarmaBitch	Karma Bitch
KeepPositive	Keep Positive
Keyfacts	Key facts
Killings	Killings
Kleinfeld	Klein feld
KoreaNo1Racoon	KoreaN o1Racoon
KushMan	KushMan
LBJ6	LBJ6
LEAVE	LEAVE
LIvTT	LIvTT
LOTcrew	LOT crew
LSE	LSE
L_AvatorMusikGroup	L_AvatorMusikGroup
Language_Solution	Language _ Solution
LastCall	Last Call
Leafsnation	Leafs nation
Legalizeit	Legalize it
LetThatMarinate	Let That Marinate
LettinGo	LettinG o
Lieing	Lie ing
LikeAGoodNeighborStateFarmIsThere	L ikeA Good Neighbor State Farm Is There
Litchfield	L itch field
LiveWild	Live Wild
Londonliesfortourists	London lies for tourists
LostDog	Lost Dog
LoveMyJob	Love My Job
Lttp	Lttp
MACINDIA	MAC INDIA
MAPoli	MA Poli
MAY27TH	MAY 27 TH
MGMT	MGMT
MJJRetweets	MJJRetweets
MLKTownHall	MLKTownHall
MPhiddenword	MP hidden word
MUZIK	MUZIK
MYLOVE	MY LOVE
MagnoliaSherbet	Magnolia Sherbet
MakingItHappen	Making It Happen
Man_U	Man _U
March9th	March 9 th
Martinea	Martin ea
Maxwell	Maxwell
Medellin	M edel lin
MenShouldnt	MenShouldnt
MiamiHeatPlaylist	Miami Heat Play list
MiamiSizzleSurvivalGuideTips	Miami SizzleS u rvivalGuideTips
Mine	Mine
MissyElliott	Missy Elliott
Moan	Moan
MongoNYC	Mo ngo NY C
MorenoValley	Moreno Valley
Motel	Motel
MrTwitter	Mr Twitter
Mustread	Must read
MyFavorites	My Favorites
MyTeam	My Team
NALS	NALS
NEPAL	NEPAL
NEWYORKKNICKS	NEWYORKK NICKS
NITEFLIGHT	NI TE FLIGHT
NOLAImIn	NO LAI mIn
NOTafan	NOTa fan
NSNDirectorsCut	NSNDirectorsCut
NYAT	NY AT
NasQuotes	Na sQuotes
Neferet	Nef e ret
NeverForgotten	Never Forgotten
NewMusicVideos	New Music Videos
NextTimeIHaveSex	Next Ti meI Have Sex
NickandMileyOnCambio	Nick and Mile yOn Cam bio
NoCutsForKids	No Cuts For Kids
NoNigga	NoNig ga
Nochance	No chance
NosyPeople	Nosy People
NothingToWear	Nothing To Wear
NowItStarts	No wIt Starts
ODD	ODD
OLDMONEY	OLD MONEY
OMGiQuoteTeen	OMGiQuoteTeen
OUtitleRun11	OU title Run 11
OfficialMusicVideo	Official Music Video
OhLetsDoIt	Oh Lets Do It
Ollie	Ollie
OnionPersonals	Onion Personals
OnlyBlackFolks	Only Black Folks
OprahLiv	Oprah Liv
OverBoardMusicVideo	OverBoard Music Video
Overweight	Overweight
PCM	PCM
PGP	PGP
PORTERHOUSEMUSICGROUP	PORTERHOUSE MUSIC GROUP
PRIMETIMECLICK	PRIME TIME CLICK
PROUDBELIEBER	PROUD BE LIEBER
Paltweets	Pal tweets
Paranormal	Paranormal
PaulGray	Paul Gray
Pdx	Pdx
Pffft	Pffft
Photoshopped	Photo shopped
PillarsOfTheEarth	Pillars Of The Earth
PleaseBackOff	PleaseB ackOff
PlentyHomo	Plenty Homo
PopMonday	Pop Monday
PowerStep	Power Step
PrayForJustinDrewBieber	Pray For Justin Drew Bieber
Princess	Princess
ProtestTheHero	Protest The Hero
ProudOfTinie	Proud Of Tin ie
Punny	Punny
QUOlumbus	QUOlum bus
QuiffsWinESC	Qui ffsWinESC
RACING	RACING
RDF	RDF
RHWOBH	RHWOBH
RIPHouseMD	RIP House MD
RISEnGRIND	RISEn GRIND
RSS	RSS
RainOnMe	Rai nOn Me
RanchoSantaMargarita	Rancho Santa Margarita
RayJ	RayJ
RealHoes	Real Hoes
RedBones	Red Bones
RedlineTrain	Redline Train
Relationships	Relationships
Reserve	Reserve
RideforHeart	Ride for Heart
Road2Recovery	Road 2 Recovery
RockYourWorld	Rock Your World
Ronny	Ronny
RunForrestRun	Run Forrest Run
SB1611	SB1611
SCII	SC II
SERIOUSLY	SERIOUSLY
SHOWRES	SHOWR ES
SINGLElife	SINGLE life
SMC3Connect	SMC3Connect
SMO	SMO
SOTA2011	S OTA 2011
SPday	SP day
STOKED	STOKED
STUDIO4	STUDIO 4
SWAGGGGGGGG	SWAGGGGGGGG
Salemia	Sale mia
Samcedes	Sam cedes
Satire	Satire
SayIt	Say It
Sculpture	Sculpture
SelenaKTU	SelenaK TU
SeriouslyTho	Seriously Tho
ShakeTheBlock	Shake The Block
Shayla	Shay la
ShineBigTime	Shine Big Time
Shotouts	Shot outs
SiegeHero	Siege Hero
SimpleNiggaProblems	Simple NiggaProblems
SkinSoSoft	Skin So Soft
SlipNSlide	SlipN Slide
Smhh	Smhh
SnowGang	Snow Gang
SoNYC	SoNY C
SomethingToBelieveIn	Something To Belie veIn
SongsforS4K	SongsforS4K
SourHour	Sour Hour
Special1TV	Special 1 TV
SpreadTheWord	Spread The Word
StaleFace	Stale Face
StartLiving	Start Living
Steezy	Steezy
Stopijeverhate	Stopij ever hate
Strongest	Strongest
SubjectToChange	Subject To Change
Sunbelt	Sunbelt
SuperMeatBoy	Super Meat Boy
SurferBoySwag	Surfer Boy Swag
SwagatarFridays	Sw aga tar Fridays
Swimsuit	Swimsuit
TDEW	TDEW
TEAMDIGGINS	TEAM DIG GINS
TEAMFUCKTHELAKERS	TEAM FUCK THE LAKERS
TEDwomen	TED women
TGCCF	TGCCF
THEREBIRTH	THE REBIRTH
THR	T HR
TNFishermen	TNFishermen
TOOGEEKED	TOOG E EKED
TRONLegacy	TRONLegacy
TUNE	TUNE
TWtobeverified	TWtobeverified
TakeYoAssBackToMyspace	Take YoAssBackToMyspace
TaxFree	Tax Free
TeamAyeeee	Team Aye eee
TeamBadass	Team Ba dass
TeamChericho	Team Cheri cho
TeamFredo	Tea mF redo
TeamGoodSex	Team Good Sex
TeamJusPaul	Team Jus Paul
TeamLang	Team Lang
TeamPia	Team Pia
TeamRetro	Team Retro
TeamSingleParent	Team Single Parent
TeamWakeAndBake	Team Wake And Bake
TeamiPHONE	Team i PHONE
TeenThinkslove	Teen Thinks love
TexasConnect	Texas Connect
ThankYouMatt	ThankYou Matt
ThatMeat	That Meat
ThatsWhyImATeen	ThatsWh yI mA Teen
TheDNAx	TheDN Ax
TheHood	The Hood
TheLastSong	The Last Song
TheRealDeal	The Real Deal
TheSunsetLimited	The Sunset Limited
Themones	Them ones
ThingsCrazyBitchesDo	Things Crazy Bitches Do
ThingsWeAllCanAgreeOn	Things WeAl lCanAgreeOn
Thrashers	Thrashers
TigerBood	Tiger Bo od
TinyUmbrella	Tiny Umbrella
Toga	Toga
TopBilling	Top Billing
TowsonLacrosse	Tow son Lacrosse
Transformations	Transformations
Tricia	Tricia
TrustAndMoveOn	TrustAndMov eOn
TweakWeek	Tweak Week
TweetYourGutsOut	Tweet Your Guts Out
TwistedSister	Twisted Sister
TwitterVirgin	Twitter Virgin
UBCgrad	U BCgrad
UGHHHHHHH	UGHHHHHHH
UND	UND
USMILEWESMILE	US MIL EWE SMILE
UnBreakable	UnBreakable
UnotMatypeCuz	Uno tM at ypeCuz
Upcoming	Upcoming
VAW	V AW
VOA	VO A
VanHollen	Van Hollen
VerifyLordBieber	Verify Lord Bieber
Virgin_Racing	Virgin _ Racing
VoteJabari	Vote Jab ari
WCRaleigh	WCRaleigh
WFP	WFP
WILDOUT	WILD OUT
WPNV	WPNV
WaWa	Wa Wa
Wale	Wale
WavyWednesday	Wavy Wednesday
WeLoveJay	We Love Jay
WeLoveYouAnt	We Love You Ant
Weedheads	Weed heads
WelcomeToSpainMcFly	Welcome To Spain Mc Fly
Wewillneverforget	We will never forget
WhatWhat	What What
WhenICameToGram	Wh enI Came To Gram
WhitneyStare	Whitney Stare
WhyTF	WhyTF
Willoughby	Willoughby
With5k	With5k
WonderGirls	Wonder Girls
Worst	Worst
WxWNC	WxWNC
YASB	YASB
YFU	YFU
YeahTeensRock	Yeah Teens Rock
Yokohama	Yokohama
YouAintFromAtlanta	You Ai ntFromAtlanta
YouMeNYC	You MeN YC
YoungWildAndFree	Young Wild And Free
Yugoslavia	Yugoslavia
Zawyia	Zawyia
aacon	aa con
ababil	ab ab il
acne	acne
adeleturningtables	adele turning tables
afool	a fool
agirlcanwish	ag i rlcanwish
airpurifiers	air purifiers
alisarmy	al is army
allgoodtho	all good tho
alwayssayalways	always say always
amateurmistake	amateur mistake
amygdala	amy gdala
answerstopopquestions	answers top opquestions
apod	a pod
arca	ar ca
arthritis	arthritis
asabaakoMUSICfestival	asa baa ko MUSIC festival
asskissery	asskissery
atltfa	atltf a
availablebox	available box
awkwardwombat	awkward wombat
ayoba	ayo ba
badads	ba dads
badone	ba done
balletclass	ballet class
baot	baot
basscannon	bass cannon
bcb10	bcb10
bealady	bea lady
bedbugs	bedbugs
beforewehadjohnandedward	be for ewe had john and edward
belieb	belieb
bestcasescenario	best case scenario
bestmoviequotes	best movie quotes
bettyIE	betty IE
biggirlnow	big girl now
billandted	bill and ted
bitchkillyourself	bitch kill yourself
blackbirds	blackbirds
blasts	blasts
bloodhoundgang	bloodhound gang
bluemoonrising	blue moon rising
boohoodotcom	boohoo dot com
bootstrapawards	bootstrap awards
boringsunday	boring sunday
bowties	bow ties
brandmanagement	brand management
brightlights	bright lights
britishteens	british teens
buct	buct
bunnies	bunnies
butchfemme	butch femme
bxwewinning	bxwewinning
caffeinated	caffein ate d
camels	camels
cantSleep	cant Sleep
careforhaiti	care for haiti
carspotting	car spotting
ccalumchat	c calum chat
ceilingfan	ceiling fan
chambananews	cham ban anew s
charlottefacts	charlotte facts
checkyourselfbeforeyouwreckyourself	check yourself before you wreck yourself
chilli	chilli
chorched	cho rched
cilip	ci lip
ckin	c kin
clevelandtweet	cleveland tweet
closeone	close one
cockpissbastards	cock piss bastards
collegebaseball	college baseball
colwood	col wood
comicRelief	comic Relief
confessionnight	confession night
conserve	conserve
cooooool	cooooool
couldgetusedtothis	could get used to this
crackberry	crack berry
creepedout	cree ped out
cruzearati	cruz e ara ti
cryn	cryn
cuteguy	cute guy
d-_-b	d-_-b
dalaillama	dalaillama
dancedancedance	dance dance dance
dashboard	dashboard
ddd9	ddd9
dealtastic	dealt as tic
delgo	del go
demonblood	demon blood
desparate	de spa rate
didIjustsaythat	didI just say that
dingleberry	dingle berry
disfunctionalfamily	dis functional family
dntgosmack	dntgosmack
dogwhisperer	dogwhisperer
dontblink	dont blink
dontexpectmeto	dont expect me to
dontwasteurtime	dontwasteur time
downersgrove	downers grove
dreamcatchers	dream catchers
dslr	dslr
dubw	dubw
dylon	dylon
eastenders26	east enders 26
eatwell	eat well
educationfest2011	education fest2011
ehi	e hi
elf	elf
engagement	engagement
envelopesystem	envelope system
epicsarcasm	epic sarcasm
etsyjewelry	etsy jewelry
ewo	ewo
external	external
eyesclosed	eyes closed
factsAboutMe	facts About Me
fakers	fakers
farouk	farouk
fast-food	fast - food
fcum	fcum
feelinggr8	feelinggr 8
ferrariofriday	ferrario friday
filmsongs	film songs
fireobama	fire obama
flameup	flame up
fli	fli
flynigga	flynig ga
followme1d	followme1d
footballnews	football news
foreverjesstweedy	forever jess tweedy
francophone	franco phone
freeBH	freeBH
freshlylaunched	freshly launched
fringe62	fringe 62
fuckfeelings	fuck feelings
fucko	fuck o
fuckudoin	fu c kudo in
fundies	f undies
futureishere	future i shere
gamefocus	game focus
gay	gay
geez	geez
gervinho	gervin ho
getfollowing	get following
getthemoney	get the money
ghsmemories	ghsmemories
girlPower	girl Power
givemehope	give me hope
goaheadanddeleteyouraccount	go ahead and delete your account
gogcsuns	go gcsuns
golfswag	golf swag
goodeducation	good education
goodshabbos	goods ha bb os
gordonbrown	gordon brown
gowest	go west
grailsx	grails x
greenbaypackers	green bay packers
grossbuttrue	gross but true
gts2	gts2
gumptownhoes	gum ptownhoes
halfmarathons	half marathons
hangengfacts	hang eng facts
happyb	happyb
happyvibes	happy vibes
harryslaw	harry slaw
haveagoodday	have a good day
headboard	headboard
heartskippedabeat	heart skipped a beat
helpusout	help us out
heylea	hey lea
hirefriday	hire friday
hititandquitit	hi tit and qui tit
hollaatme	h olla at me
homewares	home wares
horrorfilms	horror films
hotfire	hot fire
howtopissyourdudeoff	how top is syourdudeoff
humane	humane
hustleHARD	hustl eHARD
iCat	i Cat
iGotIt	i Go tIt
iOnlyTalkRight	iOn lyTalkRight
iVow	i Vow
ibmdW	ibmdW
icanthang	i can thang
ididntsaythat	idi dntsaythat
ifeelpretty	i feel pretty
ifiwasyourman	if i was your man
igivemyselfaway	i give myself away
ihatespanish	i hate spanish
iknewit	ik ne wit
ilovemycar	ilo vemycar
iloveyoureally	ilo veyoureally
imacreeper	i ma creeper
imdabest	i md a best
imjuzsaying	i mjuzsaying
imsprung	im sprung
incontinence	incontinence
indonesiasourgrapes	indonesia sour grapes
inn	inn
instantfollower	instant follower
insult	insult
iobootcamp	io boot camp
irb7s	irb7s
isthisreallife	is this real life
itreallygrindsmygears	it really grinds my gears
itsadamnshame	its adam nshame
itsicky	its icky
itwasallinmyhead	i twas allin my head
iwishiwashome	iw i shi was home
jamaicanphrases	jamaican phrases
jbb	jbb
jele	jele
jiveTolkien	jive Tolkien
jlsoncaptial	jlsoncaptial
jones2011	jones 2011
judgmentday	judgment day
justdownloaded	just downloaded
justrelease	jus trelease
kappakappagamma	kappa kappa gamma
keepGODfirst	keep GOD first
keptittooreal	kep tit too real
kevinhartquote	kevin hart quote
kindaweird	kind a weird
kingshearings	kings hearings
knowyourrole	know your role
krit	krit
ladiesFREEallNIGHT	ladies FREE all NIGHT
lamiunplugged	lami unplugged
latereply	late reply
lccc	lccc
leaveit	lea veit
lego	l ego
letsgethigh	letsg e thigh
lfp	lfp
lifeofanafrican	lifeo fan african
likeagoodneigborstatefarmisthere	likeagoodneig bor state farm is there
lionark	lio nark
litoquotes	lit oquotes
lndont	lndont
lolno	lol no
looser	looser
loveSMASH	love SMASH
loveliveteen	love live teen
lovingeveryminuteofit	lovingeverym i nu teo fit
lupusawareness	lupus awareness
lwsfun	lwsfun
maga11	maga 11
makesmelol	makesmelol
mallofamerica	mall of america
mardigras11	mardi gras 11
marvinhumes	marv inhumes
maxmsp	maxm sp
mcmexpo	mcm expo
meh2av	meh2av
menudo	menu do
mfi	mf i
microfinance	micro finance
mindplayingtricksonme	mind playing trick son me
miserybear	misery bear
mlbjp	mlbjp
moderation	moderation
momideas	mom ideas
moodmuzik4	moodmuzik 4
morningsex	morning sex
mouthorgasm	mouth orgasm
mt4sc	mt4sc
multinational	multinational
mushing	mushing
mx	mx
mylifeissoexciting	my li feis so exciting
mypoorears	mypoo rears
naca2011	na ca 2011
nastyAF	nastyAF
nationstates	nation states
neededit	need edit
nerdology	nerd ology
neversober	never sober
neworleansQuotes-	new orleans Quotes -
nfllabor	nfllabor
nge	ng e
niketalk	niketalk
nipslip	nip slip
nofocus	no focus
nomeansyes	no means yes
nooneknows	noone knows
notahappybunny	nota happy bunny
notcoolenough	not cool enough
notobill186	noto bill 186
notwinningatall	not winning atal l
nowplayingonlastfm	nowplayingonlastfm
nswblues	nswblues
nymex	nym ex
ocitacad	ocitacad
ohfuckingwell	oh fucking well
ohwelll	ohw el ll
oldtown	old town
onecausechurch	one cause church
onion	onion
onlyatBHS	onlyatBHS
oomp	oomp
oregonzoo	oregon zoo
originalityisdead	originality is dead
overforme	over for me
ozhiphop	oz hip hop
pamperme	pamper me
parathon	pa rat hon
partyoftheyear	party of the year
pazzini	paz zini
pedafile	ped a file
perfectCouples	perfect Couples
philowed	phi lowed
pickled	pickled
pissydrunk	pissy drunk
pkmn	pkmn
playing	playing
policechase	police chase
poonampandey	poonampandey
portcoquitlam	port co quit lam
powww	powww
prayforturkey	pray for turkey
predatorraw	predator raw
primedeejays	prime deejays
programmeur	programmeur
proudsis	proud sis
pubcon	pub con
pureromance	pure romance
qconlondon	qconlondon
quityourjob	quit your job
rainonmyparade	rai non my parade
randomtweetoftheday	random tweet of the day
rappin	rap pin
rde11	r de 11
realtimetwitpic	realtimetwitp ic
reasoning	reasoning
refocused	refocused
remindertoself	reminder to self
respecting	respecting
retailtweet	retail tweet
rick4sbp	rick4s bp
ripelizabethtaylor	rip elizabeth taylor
rocknroll	rockn roll
rosie	rosie
rudefood	rude food
russianspy	russian spy
rvis11	rvis11
saltyasshit	salty as shit
sandman	sandman
savebrothersandsisters	save brother sand sisters
scamnewton	scam newton
sciencia	sci en cia
scrmsummit	scrm summit
seagull	sea gull
selfbuild	self build
separatedatbirth	separated at birth
sexualharrassment	sexualharrassment
shakinmyhead	sh akin my head
shapeup	shapeup
shhhhhhhhhhh	shhhhhhhhhhh
shitsabouttogetreal	shits about to get real
shot2ss	shot 2 ss
shutyourdumbassup	shutyourdum bas sup
signoff	sign off
silentnomore	silent no more
siren	siren
skateliFe	skate liFe
slapslap	slap slap
slowlybutsurely	slowly but surely
smhRT	smhRT
smmmQ	smmmQ
snowblows	snow blows
sobased	so based
socreepy	so creepy
someoneholdme	someone hold me
sopore	so pore
soslow	so slow
southlaketahoe	southlak eta hoe
spatemedia	spate media
spork	s pork
sportstrivia	sports trivia
sscs	ss cs
statement	statement
steelerssuck	steelers suck
stillamazing	still amazing
stlnews	stl news
storystarters	story starters
streetparty	street party
stylists	stylists
subtitles	subtitles
suicideprevention	suicide prevention
sunoco	sun oco
supersowsunday	super sow sunday
svrgn_nation	svrgn_nation
swanson	swanson
symptomsofonedirectioninfection	symptoms of one direction infection
systematic	systematic
talons	talons
taxpayers	taxpayers
tdih	tdih
teamFUCKschool	team FUCK school
teamShady	team Shady
teambttm	teambt tm
teamfolloeback	team fo ll oe back
teamfreaky	team freaky
teamjaybizzleking	teamjaybizzl eking
teamprocrastination	team procrastination
teamstadt	teamstadt
teaset	tea set
telleveryone	tell everyone
texastweet	texas tweet
thankspfach	thankspfach
thatawesomemoment	that awesome moment
thatsnotsayingmuch	that snot saying much
thebach	the bach
thecataracs	the ca tara cs
thefuckery	thefuckery
themost	the most
thereisadifference	there isa difference
thewash	the wash
theworldiscomingtoanend	thew or ldiscomingtoanend
thingsiwillneverforget	thing si will never forget
thinkinside	think inside
thisrules	this rules
thtd	thtd
timetowin	time to win
tinpeiling	tin pei ling
toeic	toe ic
toolatenow	tool at enow
top10of2010	top 10 of 2010
totemapp	totem app
tractorcade	tractor cade
transition	transition
trepoundtuesdays	trepoundtuesdays
truequotes	true quotes
tryeverything	try everything
tumbl	tumbl
tweetgospel	tweet gospel
twelve	twelve
twitterafterDark	twitter after Dark
twitternecklace	twitter necklace
twittervirgin	twitter virgin
uaintnothingbutanigga	uaintnothingbutanig ga
uhmbk	uhmbk
uncalled	un called
unfuckwithable	un fuck with able
unitphone	unit phone
usda	us da
uvalax	u va lax
valium	valium
veronicamars	veronica mars
vflr	vflr
volcanic	volcanic
voterregistration	voter registration
walletpop	wallet pop
warchild	war child
wastenotwantnot	waste not want not
wblive	wblive
wec53	we c 53
weekendflow	weekend flow
welcometomyhood	welcome tom yhood
weloveourpets	we love our pets
wewantfaberry	wewantf a berry
whackass	whack ass
whatevertrevor	whatever trevor
whenihadmyspace	wh eni had my space
whileyouweresleeping	while you were sleeping
whoKnew	who Knew
whoompthereitis	who ompthereitis
wifethatbitch	wife that bitch
winewednesday	wine wednesday
wired	wired
wofire	wofire
woohoooo	woohoooo
wordyo	wordyo
worstplace	worst place
wreckingball2011	wrecking ball 2011
wyclefjean	wyclefjean
yaDIG	yaDIG
year2011	year 2011
yegarts	yeg arts
youaintgotnoyezzyinyourVEVO	youaintgotnoyezzyinyourV E VO
youhavenoidea	youhav eno idea
youknowyoumexican	you know you mexican
youmakesmile	you make smile
yoursinglebecause	your single because
youthinkthatway	you think that way
yyzweather	yyzweather
